....................
....................
..........######....
...............#....
....................
....................
....................
....................
....................
......#.............
......#.............
......#.............
......#####.........
....................
....................